11111111111111111
1P000000000001001
111000C0000110E11
1100C000000000001
11000000000C00101
11000000000000001
11000000000000001
1010C000000000G01
10000000C00000001
11111111111111111
