111111111111111111111111111
1P0000000000010000000000001
111000C0000110E000000000011
1100C00000G0000000000000001
11000000000C000000000000101
11000G000110000000000000001
110000010000000000000000001
1010C0000000100000000000001
10000000C000000000000000001
111111111111111111111111111
